# # # # # # # # # # # # # #
# 2 # 0 0 0 # 0 0 0 0 0 0 #
# 0 # 0 # 0 # 0 # # # # 0 #
# 0 # 0 # 0 # 0 # 0 0 0 0 #
# 0 # 0 # 0 # 0 # 0 # # # #
# 0 # 0 # 0 # 0 # 0 0 0 0 #
# 0 0 0 # 0 0 0 # # # 5 # #
# # # # # # # # # # # # # #